7 44
00000000000000000000000000000000000000000000
00000000000000000000000000000000000000000000
01111b10101101001001010101111111011101111111
01111110101101001001010101111111011101111111
01111110101101001001010101111111011111111111
11111111111111111111111111111111111111111111
000000000000NORMAL0000000DEUX000000000000000
5
4 1
1
1
1
1
2 2
11
11
2 3
010
111
2 3
110
011
2 3
011
110
3 7
15
1
2
3
4
4
3
2
1
3
4
1
2
2
1
3

                                           
                                           