7 44
00000000000000000000000000000000000000000000
00000000000000000000000000000000000000000000
01111110101101001001010101111111011101111111
01111110101101001001010101111111011101111111
01111110101101001001010101111111011101111111
11111111111111111111111111111111111111111111
0000000000DIFFICILE000DEUX000000000000000000
5
4 1
1
1
1
1
2 2
11
11
2 3
010
111
2 3
110
011
2 3
011
110
1 8
17
1
1
1
2
3
4
4
4
4
3
2
2
4
3
4
3
4